# keybindsMenu
> Change keybinds=> Przypisane klawisze
REMAP CONTROLS=STEROWANIE
Walk forward=Idź do przodu
Walk back=Idź do tyłu
Walk left=Idź w lewo
Walk right=Idź w prawo
Jump=Skok
Crouch=Skradanie się
Interact=Interakcja
Ping scan=Skanowanie
Item primary use=Użyj przedmiot [1]
Item Secondary use=Użyj przedmiot [2]
Item Tertiary use=Użyj przedmiot [3]
Item drop=Upuść przedmiot
Item switch left=Wybierz przedmiot [1]
Item switch right=Wybierz przedmiot [2]
Item inspect=Sprawdź przedmiot
Replace furniture=Przestaw dekorację
Turn furniture=Obróć dekorację
Store furniture=Przenieś dekorację do magazynu
Dance=Tańcz
Point=Wskaż
Enable chat=Napisz wiadomość
Submit chat=Wyślij wiadomość
REBIND CONTROLLERS=STEROWANIE KONTROLEREM
Move forward=Idź do przodu
Move back=Idź do tyłu
Move left=Idź w lewo
Move right=Idź w prawo
Item secondary use=Użyj przedmiot [2]
Item tertiary use=Użyj przedmiot [3]
> Set to defaults=> Zresetuj wszystkie
Push to talk=Naciśnij, aby mówić
Space=SPACE
Shift=SHIFT
Control=CONTROL
Right Button=PPM
Left Button=LPM
Scroll/Down=SCROLL\n↓
Scroll/Up=SCROLL\n↑
Enter=ENTER
